%%%%%
%S  %
%R  %
%T  %
%M  %
%   %
%%%%%