%%%%%
%S  %
%  R%
% T %
%  M%
%%%%%