%%%%%
% M %
%   %
%R T%
% S %
%%%%%