%%%%%
%R  %
%   %
%T  %
%M  %
%S  %
%%%%%